House4	Assets/Models/StaticMesh/MapObject/House4.ASE
Wooden_Fence__Long_A	Assets/Models/StaticMesh/MapObject/Wooden_Fence__Long_A.ASE
Floor	Assets/Models/StaticMesh/MapObject/Floor.ASE
table_A	Assets/Models/StaticMesh/MapObject/table_A.ASE
Rock_2	Assets/Models/StaticMesh/MapObject/Rock_2.ASE
House2	Assets/Models/StaticMesh/MapObject/House2.ASE
Rock_4	Assets/Models/StaticMesh/MapObject/Rock_4.ASE
Floor_A	Assets/Models/StaticMesh/MapObject/Floor_A.ASE
statue	Assets/Models/StaticMesh/MapObject/statue.ASE
spiderweb_D	Assets/Models/StaticMesh/MapObject/spiderweb_D.ASE
forest_grass	Assets/Models/StaticMesh/MapObject/forest_grass.ASE
House_A	Assets/Models/StaticMesh/MapObject/House_A.ASE
forest_ground	Assets/Models/StaticMesh/MapObject/forest_ground.ASE
rock_flat	Assets/Models/StaticMesh/MapObject/rock_flat.ASE
House1	Assets/Models/StaticMesh/MapObject/House1.ASE
House3	Assets/Models/StaticMesh/MapObject/House3.ASE
Medieval_House	Assets/Models/StaticMesh/MapObject/Medieval_House.ASE
mobile_pillar01	Assets/Models/StaticMesh/MapObject/mobile_pillar01.ASE
Com_Geometry	Assets/Models/StaticMesh/MapObject/Com_Geometry.ASE
rock_A2	Assets/Models/StaticMesh/MapObject/rock_A2.ASE
mobile_pillar01_b	Assets/Models/StaticMesh/MapObject/mobile_pillar01_b.ASE
wall_A	Assets/Models/StaticMesh/MapObject/wall_A.ASE
mobile_pillar01_c	Assets/Models/StaticMesh/MapObject/mobile_pillar01_c.ASE
moss_A	Assets/Models/StaticMesh/MapObject/moss_A.ASE
moss_B	Assets/Models/StaticMesh/MapObject/moss_B.ASE
mud_A	Assets/Models/StaticMesh/MapObject/mud_A.ASE
mushroom_A	Assets/Models/StaticMesh/MapObject/mushroom_A.ASE
Rock_6	Assets/Models/StaticMesh/MapObject/Rock_6.ASE
Old_House	Assets/Models/StaticMesh/MapObject/Old_House.ASE
Royal_town_house_4	Assets/Models/StaticMesh/MapObject/Royal_town_house_4.ASE
pillar_A	Assets/Models/StaticMesh/MapObject/pillar_A.ASE
wall_A3	Assets/Models/StaticMesh/MapObject/wall_A3.ASE
pillar01	Assets/Models/StaticMesh/MapObject/pillar01.ASE
torch_A2	Assets/Models/StaticMesh/MapObject/torch_A2.ASE
pillar01_b	Assets/Models/StaticMesh/MapObject/pillar01_b.ASE
pillar01_c	Assets/Models/StaticMesh/MapObject/pillar01_c.ASE
spiderweb_C	Assets/Models/StaticMesh/MapObject/spiderweb_C.ASE
skull	Assets/Models/StaticMesh/MapObject/skull.ASE
pot_A	Assets/Models/StaticMesh/MapObject/pot_A.ASE
Screaming_statue	Assets/Models/StaticMesh/MapObject/Screaming_statue.ASE
pot_B	Assets/Models/StaticMesh/MapObject/pot_B.ASE
stool_A	Assets/Models/StaticMesh/MapObject/stool_A.ASE
Rock_7	Assets/Models/StaticMesh/MapObject/Rock_7.ASE
Rock	Assets/Models/StaticMesh/MapObject/Rock.ASE
statue_head	Assets/Models/StaticMesh/MapObject/statue_head.ASE
Wooden_Fence__Long_B	Assets/Models/StaticMesh/MapObject/Wooden_Fence__Long_B.ASE
Rock_1	Assets/Models/StaticMesh/MapObject/Rock_1.ASE
Rock_3	Assets/Models/StaticMesh/MapObject/Rock_3.ASE
Rock_5	Assets/Models/StaticMesh/MapObject/Rock_5.ASE
statue_broken	Assets/Models/StaticMesh/MapObject/statue_broken.ASE
Rock_8	Assets/Models/StaticMesh/MapObject/Rock_8.ASE
rock_A	Assets/Models/StaticMesh/MapObject/rock_A.ASE
Royal_town_house_1	Assets/Models/StaticMesh/MapObject/Royal_town_house_1.ASE
spiderweb_A	Assets/Models/StaticMesh/MapObject/spiderweb_A.ASE
torch_A	Assets/Models/StaticMesh/MapObject/torch_A.ASE
spiderweb_B	Assets/Models/StaticMesh/MapObject/spiderweb_B.ASE
staticMesh	Assets/Models/StaticMesh/MapObject/staticMesh.ASE
staticMesh2	Assets/Models/StaticMesh/MapObject/staticMesh2.ASE
StoneFence_Post_LOD0	Assets/Models/StaticMesh/MapObject/StoneFence_Post_LOD0.ASE
Tree_A	Assets/Models/StaticMesh/MapObject/Tree_A.ASE
wall_A2	Assets/Models/StaticMesh/MapObject/wall_A2.ASE
water_well	Assets/Models/StaticMesh/MapObject/water_well.ASE
Woodbase-BrickSupport-Fence	Assets/Models/StaticMesh/MapObject/Woodbase-BrickSupport-Fence.ASE
Woodbase-BrickSupport-Fence_Pillar	Assets/Models/StaticMesh/MapObject/Woodbase-BrickSupport-Fence_Pillar.ASE
Woodbase-BrickSupport-Fence_Basic	Assets/Models/StaticMesh/MapObject/Woodbase-BrickSupport-Fence_Basic.ASE
Woodbase-BrickSupport-Fence_Full	Assets/Models/StaticMesh/MapObject/Woodbase-BrickSupport-Fence_Full.ASE
Wooden_fence_A	Assets/Models/StaticMesh/MapObject/Wooden_fence_A.ASE
Wooden_Fence_B	Assets/Models/StaticMesh/MapObject/Wooden_Fence_B.ASE
wooden_fence_C	Assets/Models/StaticMesh/MapObject/wooden_fence_C.ASE
wooden_fence_D	Assets/Models/StaticMesh/MapObject/wooden_fence_D.ASE
wooden_fence_E	Assets/Models/StaticMesh/MapObject/wooden_fence_E.ASE
wooden_fence_F	Assets/Models/StaticMesh/MapObject/wooden_fence_F.ASE
Barrel_A	Assets/Models/StaticMesh/MapObject/Barrel_A.ASE
Brick_Wall_Dummy	Assets/Models/StaticMesh/MapObject/Brick_Wall_Dummy.ASE
Broken_Wooden_Fence_B	Assets/Models/StaticMesh/MapObject/Broken_Wooden_Fence_B.ASE
